1111111111111111111111111111111111
1000000000000000001010000000000001
1010010100100000001C01000000010101
1010010C10101010001100000000010111
1P000000000000000000000000EE001101
1111111111111111111111111111111111